000000000010000100000000000000
000001111010000100000000000000
000001001010010100000000000000
000001001010010100000000000000
001111001010010100000000000000
001000001011110100000000000000
011000001000000100000000000000
010001001111111100000000000000
000001000000000000000000000000
000011111100000000000000000000
111110000000000000000000000000
000000000000000000000000000000
000000000000000000000000000000
000000000000000000000000000000
000000000000000000000000000000
000000000000000000000000000000
000000000000000000000000000000
000000000000000000000000000000
000000000000000000000000000000
000000000000000000000000000000
